NO ./path_texture.xpm
SO ./path_texture.xpm
WE ./path_texture.xpm
EA ./path_texture.xpm



F 0, 252  ,0
C 1,2,3

1  1        1 
111011     11011
1111111  11111111
100001
10N0001
111111
1 101
11111