NO ./path_texture.xpm
SO ./path_texture.xpm
WE ./path_texture.xpm
EA ./path_texture.xpm



 11111

 
F 0,252,0
C 1,2,3


1111111
10N001
121111
111111