NO ./path_texture.xpm
SO ./path_texture.xpm
WE ./path_texture.xpm
EA ./path_texture.xpm



F 0, 2 5 2  ,0
C 1,2,3

1  1        111
111011     11011
1111111111111111
100001
10N0001
111111
1 101
11111