NO ./textures/north.xpm
SO ./textures/south.xpm
WE ./textures/east.xpm
EA ./textures/west.xpm

F 255,255,255
C 196,210,225

 11111111
1000000001
1000000001
1000000001
10000N0001
1000000001
1000000001
1000000001
1000000001
 11111111