NO ./textures/north.xpm
SO ./textures/south.xpm
WE ./textures/east.xpm
EA ./textures/west.xpm

F 255,255,255
C 196,210,225


1111
1001
1111
 11111111
1000000001
1000000001
 11100111
10000N0001
 11111111
1000000001
1000000001
1111111111
    1111111111
    1000000001
     11111111