NO ./textures/north.xpm
SO ./textures/south.xpm
WE ./textures/east.xpm
EA ./textures/west.xpm

F 255,255,255
C 196,210,225

111111111111111111111
1000000000000000000E1
111111111111111111111
