NO ./textures/north.xpm
SO ./textures/south.xpm
WE ./textures/east.xpm
EA ./textures/west.xpm

F 255,255,255
C 196,210,225


1111111111111
 11101110111
10000000001
 111100001
  11N0011
   10111
  11111111