NO ./textures/north.xpm
SO ./textures/south.xpm
WE ./textures/east.xpm
EA ./textures/west.xpm

F 255,255,255
C 196,210,225

11111111111111
    1N1
11111111111111