WE
NO ./textures/north.xpm
SO ./textures/south.xpm
EA ./textures/east.xpm

C 255,100,100
F 255,50,50

1111111111
1000N00001
1000000001
1000000001
1000000001
1000000001
1000000001
1000000001
1000000001
1111111111